0 10 10 0 1 1 9 
5 -1 5 5 5 5 5 5 5 5
5 0 5 5 5 5 5 0 0 1
5 0 5 0 5 5 5 0 5 5
5 0 5 0 0 0 0 0 5 5
5 0 0 5 5 0 5 5 5 5
5 5 0 5 5 0 0 0 0 5
5 5 0 0 0 0 5 5 0 5
5 5 5 5 0 5 5 5 0 0
5 5 5 5 0 0 0 0 5 5
5 5 5 5 5 5 5 5 5 5